0,0,0,0,0,0,6,0,5,0,5,5,0,0,5,0,0,0,0,0,0,6,0,5,0,7,0,5,5,0,0,0,5,5
5,0,5,0,0,0,0,5,0,5,0,0,0,0,0,5,5,0,5,0,0,5,5,0,5,0,0,0,0,5,0,5,0,0
5,0,0,0,7,0,5,5,0,0,0,0,0,7,6,5,5,0,0,0,7,5,5,0,0,0,7,0,5,5,0,0,0,5
0,0,0,0,5,0,0,0,0,0,5,5,6,0,5,6,0,0,0,0,5,0,5,0,5,0,0,0,0,5,0,5,0,0
6,0,5,0,0,0,0,0,7,0,0,0,0,5,5,0,6,0,5,0,0,6,5,0,0,0,7,0,5,5,0,0,0,5
0,7,0,0,0,0,6,5,0,0,0,6,0,0,6,6,5,0,5,0,0,0,0,0,0,0,5,0,0,0,0,0,5,0
5,0,0,5,0,0,0,0,0,7,0,0,5,5,5,6,5,0,0,5,0,0,6,0,5,0,0,0,0,0,7,0,0,0
0,0,5,0,5,0,0,5,0,0,6,0,0,0,0,6,0,6,0,0,5,0,5,0,0,0,5,0,0,0,0,5,0,0
0,5,0,6,0,0,5,0,0,0,0,0,7,0,0,0,0,0,5,0,0,0,6,0,0,0,0,0,0,0,0,0,0,0
0,0,0,0,0,5,0,6,0,0,0,6,0,0,7,0,0,0,0,5,0,0,0,0,5,0,0,0,0,5,0,0,0,0
0,6,0,0,0,0,0,0,5,0,0,0,6,0,0,5,0,0,5,0,0,5,0,0,0,0,7,0,0,0,0,7,0,0
0,0,6,0,0,6,0,0,0,54,55,55,55,55,69,69,69,55,55,55,55,55,69,56,0,0,0,0,0,0,0,0,0,0
0,0,0,5,0,0,6,0,0,57,26,26,26,78,25,25,25,25,78,36,78,25,79,59,0,5,0,0,5,0,5,0,0,5
0,0,7,0,0,0,0,5,0,57,77,77,77,74,25,25,25,25,25,25,25,25,25,59,0,0,0,0,0,0,0,0,0,0
0,5,0,6,0,0,7,0,0,57,25,25,25,25,25,25,25,25,25,25,25,25,25,59,0,7,0,0,0,0,7,0,0,0
0,0,0,0,0,5,0,6,0,57,25,25,32,25,38,25,38,25,38,25,31,25,25,59,5,0,0,5,0,5,0,0,5,0
5,0,0,5,0,0,0,0,0,57,25,25,25,25,25,25,25,25,25,25,25,25,25,59,0,5,0,0,0,0,5,0,0,0
0,0,5,0,0,0,0,5,0,57,77,73,25,25,25,76,77,77,77,77,73,25,25,59,0,0,6,0,0,0,0,6,0,0
0,5,0,6,7,0,0,0,7,57,79,78,25,25,25,78,47,47,47,47,78,25,79,59,0,7,0,5,0,0,7,0,5,0
0,0,0,0,0,0,6,0,0,60,61,61,70,61,70,61,61,61,61,61,61,70,61,62,0,0,0,0,0,0,0,0,0,0
0,6,0,0,0,0,0,0,6,0,0,0,0,0,0,0,0,0,0,0,0,0,0,0,0,5,0,0,0,0,5,0,0,0
0,0,6,0,0,7,6,5,5,0,0,6,0,0,0,5,0,6,0,7,0,0,6,0,0,5,0,5,5,0,5,0,5,0
0,0,0,5,6,0,5,6,5,0,0,0,0,7,0,0,0,0,0,0,0,5,0,0,0,0,0,0,0,0,0,0,0,0
0,0,7,0,0,5,5,0,5,5,5,0,0,0,0,0,0,0,0,0,0,0,0,0,0,0,0,5,0,0,0,0,5,0
0,5,0,6,0,0,6,6,0,5,0,5,0,0,0,0,5,0,5,0,0,0,6,0,0,0,0,0,0,0,0,0,0,0
0,0,0,0,5,5,5,6,5,5,0,0,0,5,0,5,5,0,0,5,5,5,5,0,5,5,0,0,0,5,6,0,0,0
0,0,0,5,0,0,5,0,0,0,0,0,0,5,0,0,0,0,0,5,0,0,0,0,0,0,0,7,5,0,0,0,7,0
7,0,0,0,0,0,0,0,0,6,0,5,0,0,0,0,0,7,0,0,0,5,0,0,0,0,0,0,0,0,0,0,0,0
0,0,6,0,6,5,0,0,0,0,7,0,0,0,0,6,5,0,0,0,0,7,0,6,5,0,0,0,0,7,0,0,0,0
0,0,0,0,0,5,5,5,0,0,0,0,0,0,0,0,5,5,5,0,0,0,0,0,5,5,5,0,0,0,0,0,0,0
0,7,6,5,6,0,5,0,5,0,0,0,0,5,0,6,0,5,0,5,0,0,0,6,0,5,0,5,0,0,0,0,5,0
6,0,5,6,6,5,5,0,0,0,7,0,5,5,0,6,5,5,0,0,0,7,0,6,5,5,0,0,0,7,0,5,5,0
0,0,0,0,0,0,6,0,5,0,0,0,0,0,0,0,0,0,0,0,0,0,0,6,0,5,0,0,0,0,0,7,0,0
0,6,0,0,0,0,6,0,5,0,0,0,0,0,7,0,0,6,6,6,0,7,0,5,0,7,0,5,5,0,0,0,5,5
